보다	타동사
받다	타동사
서다	자타동사
나서다	자동사
하다	자타동사
닫다	타동사
끓다	자동사
만나다	자타동사
터뜨리다	타동사
믿다	타동사
오다	자동사
둘러보다	타동사
돌아다니다	자동사
이루어지다	자동사
노리다	타동사
짓다	자타동사
돌리다	자타동사
커지다	자동사
어찌하다	자동사
말하다	자타동사
타다	자타동사
바라다	타동사
늦추다	타동사
빚다	타동사
넘다	자타동사
잡다	타동사
떠나다	자타동사
바꾸다	타동사
꾸리다	타동사
미루다	타동사
고다	타동사
원하다	타동사
대하다	자타동사
위하다	타동사
나오다	자동사
모르다	타동사
전하다	타동사
인하다	자타동사
일다	타동사
겪다	타동사
통하다	자타동사
보내다	타동사
맞다	자타동사
남기다	타동사
거치다	자타동사
정하다	타동사
열리다	자동사
둘러싸다	타동사
벌어지다	자동사
가다	자동사
맞서다	자동사
풀다	타동사
품다	타동사
붙이다	타동사
지나다	자동사
내놓다	타동사
두다	타동사
바라보다	타동사
되다	자타동사
오르다	자타동사
감싸다	타동사
끌어들이다	타동사
안다	타동사
주다	타동사
내다	자타동사
갖다	타동사
어울리다	자동사
묵다	자동사
더하다	자타동사
졸다	자타동사
밝다	자동사
힘내다	자동사
참다	타동사
찾다	타동사
담다	타동사
꿈꾸다	타동사
이루다	타동사
돌아오다	자동사
호다	자타동사
흥청거리다	자동사
치다	자타동사
나아지다	자동사
태어나다	자동사
되찾다	타동사
지다	자타동사
떨치다	자타동사
쓰다	타동사
낳다	타동사
살다	자타동사
걸치다	자동사
긷다	자타동사
풍치다	자동사
즐기다	타동사
묻다	자타동사
벗다	타동사
뒤덮다	타동사
잠자다	자동사
익다	자동사
살아가다	자동사
이어지다	자동사
잇다	타동사
펼치다	타동사
쑤다	타동사
변하다	자동사
놓다	타동사
잡히다	자타동사
떨어지다	자동사
베다	타동사
옮기다	타동사
쉬다	자타동사
넘치다	자동사
팔다	타동사
의하다	자동사
읽다	타동사
답하다	자동사
닮다	타동사
좋아하다	타동사
박다	타동사
넣다	타동사
삶다	타동사
먹다	자타동사
벗하다	자동사
웃다	자동사
싸다	타동사
뒤지다	자타동사
빛나다	자동사
향하다	자타동사
죽다	자동사
벌이다	자타동사
따지다	타동사
내세우다	타동사
높아지다	자동사
생기다	자동사
잃다	타동사
내주다	자타동사
대다	타동사
기대다	자타동사
밀리다	자동사
힘입다	자동사
몰리다	자동사
기다리다	타동사
일어나다	자동사
일으키다	타동사
삼다	타동사
나아가다	자동사
나다	자타동사
드러나다	자동사
내다보다	타동사
주되다	자동사
나타나다	자동사
적다	타동사
그치다	자동사
느끼다	자타동사
자다	자타동사
미끈거리다	자동사
손잡다	타동사
끈적이다	자동사
나누다	타동사
사다	타동사
줄다	자동사
분하다	자타동사
다가오다	자동사
당하다	자타동사
퍼지다	자동사
곤두박질치다	자동사
미치다	자타동사
견디다	자타동사
달하다	자동사
오래가다	자동사
끝나다	자동사
가르치다	타동사
따다	타동사
외다	타동사
끼치다	타동사
맡다	타동사
사로잡다	타동사
밀어내다	타동사
다루다	타동사
몰아내다	타동사
건드리다	타동사
빼다	타동사
공치다	타동사
빌리다	타동사
풀어내다	타동사
구워삶다	타동사
들어오다	자동사
막다	타동사
달라지다	자동사
내려다보다	타동사
드러내다	타동사
감추다	타동사
다니다	자타동사
받아들이다	타동사
지내다	자동사
가지다	타동사
불리다	타동사
따르다	타동사
따라가다	타동사
헤치다	타동사
임하다	자동사
늘어나다	자동사
들어가다	자동사
뽑다	타동사
택하다	타동사
구하다	타동사
붙다	자동사
다녀오다	자타동사
비하다	타동사
낮아지다	자동사
다투다	자동사
쏟다	타동사
가리다	자타동사
숨기다	타동사
가다듬다	타동사
비치다	자타동사
녹다	자동사
불거지다	자동사
일하다	자동사
처하다	자동사
이르다	자동사
던지다	타동사
물러나다	자동사
뿌리다	자동사
알아내다	타동사
걸리다	자동사
찾아내다	타동사
삐걱거리다	자동사
속하다	자타동사
눕다	타동사
내려오다	자동사
실리다	자동사
그리다	타동사
헤매다	자동사
입다	타동사
스러지다	자동사
모이다	자동사
말다	타동사
띠다	타동사
합치다	타동사
맺다	타동사
비롯하다	타동사
벌거벗다	자동사
엿보다	타동사
차리다	타동사
딛다	타동사
망하다	자동사
새다	자타동사
여닫다	타동사
달리다	자동사
두르다	타동사
들락거리다	자동사
들어서다	자동사
파헤치다	타동사
새기다	타동사
몰아넣다	타동사
빠뜨리다	타동사
띄다	자동사
거듭나다	자동사
지키다	타동사
갖추다	타동사
채우다	타동사
해내다	타동사
비비다	타동사
나르다	자타동사
유래되다	자동사
건너다	타동사
알리어지다	자동사
골다	타동사
돌아가다	자동사
돌아서다	자동사
여기다	타동사
달려오다	자동사
걷다	자타동사
날리다	자타동사
없애다	타동사
갈다	타동사
번지다	자동사
관하다	자동사
빠지다	자동사
사라지다	자동사
지지다	자타동사
붉어지다	자동사
살아나다	자동사
되새기다	타동사
내보내다	타동사
깨다	자타동사
접하다	자타동사
건네다	타동사
가두다	타동사
찍다	자타동사
벗어나다	자타동사
매다	타동사
알아보다	타동사
이다	타동사
내리다	자타동사
뒤집다	타동사
들추다	타동사
뚫다	타동사
때리다	타동사
거두다	자타동사
이기다	자타동사
몰아치다	타동사
따라붙다	자동사
두들기다	타동사
틀어막다	타동사
떠오르다	자동사
물리치다	타동사
터지다	자동사
누르다	타동사
불러들이다	타동사
펴다	타동사
피하다	타동사
가져오다	타동사
어기다	타동사
고르다	타동사
심다	타동사
빗발치다	자동사
기다	자타동사
마치다	자타동사
닿다	자동사
곱하다	타동사
치솟다	자동사
깨지다	자동사
챙기다	타동사
맞추다	타동사
신다	타동사
면하다	자타동사
마르다	타동사
움켜쥐다	타동사
털어놓다	타동사
쥐다	타동사
조이다	타동사
두드리다	타동사
찾아오다	타동사
떼이다	타동사
버티다	자동사
살피다	타동사
쌓다	타동사
제하다	자타동사
내려앉다	자동사
아끼다	타동사
내비치다	자타동사
꾸다	타동사
매이다	자동사
뛰다	자타동사
깔다	자타동사
놀라다	자동사
합하다	자동사
바치다	타동사
짚다	타동사
떨리다	자동사
쓰다듬다	타동사
더듬다	타동사
밟다	타동사
물러서다	자동사
누비다	자타동사
다리다	자타동사
싸우다	자동사
배우다	타동사
외우다	타동사
쓰이다	자동사
찾아보다	타동사
살펴보다	타동사
채다	자타동사
트다	자타동사
놓치다	타동사
남다	자동사
뛰어오르다	자동사
매기다	자타동사
취하다	자타동사
지나치다	자동사
꿇다	타동사
조아리다	타동사
접다	타동사
끊이다	자동사
돌아보다	타동사
말리다	자타동사
뒤엎다	타동사
부려먹다	타동사
동동거리다	자타동사
튀다	자동사
기발하다	자동사
차다	자타동사
밀다	자타동사
일깨우다	타동사
버무리다	타동사
날다	자타동사
반짝이다	자타동사
뿜어내다	타동사
꾸미다	타동사
맛보다	타동사
주고받다	타동사
치켜세우다	타동사
데리다	타동사
몰다	타동사
배다	자타동사
가까워지다	자동사
끊다	타동사
켜다	타동사
불붙다	자동사
쏘다	타동사
당기다	타동사
부수다	자타동사
식다	자동사
거들떠보다	타동사
때다	자타동사
다하다	자타동사
주무르다	타동사
엇갈리다	자동사
불러오다	타동사
망가지다	자동사
내쫓다	타동사
올라오다	자동사
잊다	타동사
그만두다	타동사
섞다	타동사
덜렁거리다	자동사
꺼내다	타동사
끼다	자타동사
빗나가다	자타동사
쏟아지다	자동사
멀리하다	타동사
오가다	자타동사
잦아지다	자동사
건너오다	타동사
올라가다	자동사
멈추다	자타동사
없어지다	자동사
꺼지다	자동사
꺾다	타동사
두려워하다	타동사
앓다	타동사
같이하다	타동사
들이켜다	타동사
떼다	타동사
맞받다	타동사
응하다	자동사
꼽다	타동사
불러일으키다	타동사
다가서다	자동사
데다	자타동사
멀다	자동사
어리다	자동사
외치다	자동사
눈여겨보다	타동사
데려가다	타동사
돌보다	타동사
보살피다	타동사
눕히다	타동사
가하다	타동사
그리워하다	타동사
펄럭이다	자동사
들여오다	타동사
갈아엎다	타동사
술렁이다	자동사
밀어붙이다	타동사
다듬다	타동사
헤아리다	타동사
다치다	타동사
비추다	자타동사
해오다	타동사
고치다	타동사
바로잡다	타동사
끌어모으다	자동사
자보다	자동사
캐내다	타동사
허덕이다	자동사
불타다	자동사
파다	타동사
띄우다	타동사
묶다	타동사
본받다	타동사
뭉치다	자동사
추다	타동사
지르다	자타동사
달라붙다	자동사
날아오다	자동사
쏠리다	자동사
헤다	자타동사
내뿜다	타동사
기죽다	자동사
다독거리다	타동사
맞붙다	자동사
추리다	자타동사
다지다	타동사
감돌다	자타동사
마시다	타동사
처지다	자동사
무너지다	자동사
자르다	타동사
꺼리다	타동사
쫓겨나다	자동사
비아냥거리다	자동사
기뻐하다	자동사
넘어가다	자동사
옮아가다	자동사
쫓다	타동사
넘보다	타동사
도사리다	타동사
드리우다	타동사
맞붙이다	타동사
앉다	자동사
얹다	타동사
곁들이다	타동사
권하다	타동사
얼싸안다	타동사
뜻하다	타동사
다녀가다	자동사
버리다	타동사
사들이다	타동사
어우러지다	자동사
끼얹다	타동사
움직이다	자동사
쪼개다	자동사
상하다	자타동사
가져가다	타동사
아쉬워하다	타동사
구기다	자타동사
올라서다	자동사
넘어서다	타동사
서슴다	자동사
지니다	타동사
달려가다	자동사
틀다	자타동사
표하다	타동사
거느리다	타동사
파하다	자타동사
들여다보다	타동사
되돌아가다	자동사
겹치다	자동사
피다	자타동사
잃어버리다	타동사
빗다	자타동사
도지다	자동사
엮다	타동사
틀리다	자동사
때우다	타동사
지나오다	타동사
걸어가다	자동사
부닥치다	자동사
망치다	타동사
따돌리다	타동사
세다	자타동사
드리다	타동사
달이다	타동사
스치다	타동사
꿰다	타동사
뽐내다	자동사
볶다	타동사
청하다	타동사
끌어올리다	타동사
진하다	자동사
들이마시다	타동사
겨루다	타동사
갈아타다	타동사
물리다	자타동사
끌어내다	타동사
들키다	자동사
닦다	타동사
내려놓다	타동사
뛰어넘다	타동사
따라잡다	타동사
축이다	타동사
펴내다	타동사
반하다	자타동사
꼬집다	타동사
닥치다	자동사
노려보다	타동사
쫓아다니다	자동사
쥐어짜다	타동사
달리하다	타동사
부딪치다	자동사
우리다	자타동사
뒤떨어지다	자동사
설치다	자타동사
견주다	타동사
기르다	자타동사
한하다	타동사
굳어지다	자동사
달래다	타동사
삼키다	타동사
부추기다	타동사
자지러지다	자동사
흐느끼다	자동사
들먹이다	자동사
부여잡다	타동사
삭다	자동사
찌다	자타동사
우러나다	자동사
으깨다	타동사
짜다	타동사
곰삭다	자동사
집다	타동사
찌르다	자타동사
늙다	자동사
마다하다	타동사
지우다	자타동사
나부끼다	자동사
가라앉다	자동사
보태다	자타동사
자라다	자동사
덜커덩거리다	자동사
들리다	자동사
지나가다	자동사
경사지다	자동사
평하다	타동사
내두르다	타동사
훔치다	타동사
달아나다	자동사
시달리다	자동사
타내다	타동사
밤새우다	자동사
씻다	타동사
질리다	자동사
내디디다	타동사
새우다	타동사
부치다	자타동사
담쌓다	자동사
타보다	자동사
치우다	타동사
덮다	타동사
안타까워하다	타동사
다그치다	타동사
뜨거워지다	자타동사
댕기다	자동사
꾀하다	타동사
준하다	자동사
일구다	타동사
풀리다	자동사
퍼뜨리다	타동사
아른거리다	자동사
빌다	타동사
가리키다	타동사
줍다	타동사
자라나다	자동사
딸리다	자동사
눈감다	자동사
부러지다	자동사
읊다	타동사
사주다	자타동사
사귀다	자동사
몰라보다	타동사
약하다	타동사
무너뜨리다	타동사
죄다	타동사
몸담다	자동사
밀려나다	자동사
얇아지다	자동사
빼먹다	타동사
빼놓다	타동사
만지다	타동사
겸하다	타동사
찢다	타동사
마주치다	자동사
가로막다	타동사
요하다	타동사
모자라다	자동사
굴하다	자동사
가르다	타동사
빌어먹다	자동사
에다	타동사
터놓다	타동사
뛰어오다	자동사
숨다	자동사
비꼬다	타동사
메우다	타동사
먹이다	타동사
허우적거리다	자동사
덧대다	타동사
헤집다	타동사
지치다	타동사
건지다	타동사
가려내다	타동사
뛰어다니다	자동사
무치다	타동사
목메다	자동사
갈아입다	자동사
뒤엉키다	자동사
흐트러지다	자동사
후려치다	타동사
뱉다	타동사
헐다	자동사
두근거리다	자동사
화나다	자동사
내던지다	타동사
깨부수다	타동사
후비다	타동사
물어뜯다	타동사
짓찧다	타동사
걷어차다	타동사
이어받다	타동사
패다	자타동사
뻗치다	자동사
갈라지다	자동사
잡아당기다	타동사
쥐어뜯다	타동사
널리다	타동사
찢어지다	자동사
꿰매다	타동사
붙잡다	타동사
쩔쩔매다	자동사
따라오다	타동사
구부리다	타동사
굴리다	타동사
다가가다	자동사
다스리다	타동사
닥쳐오다	자동사
건너가다	타동사
깨뜨리다	타동사
내리쬐다	자동사
트이다	자동사
흘러내리다	자동사
주저앉다	자동사
꼬이다	자타동사
끝마치다	타동사
우려먹다	타동사
그릇되다	자동사
반기다	자동사
얻어맞다	자동사
패하다	자동사
가꾸다	타동사
투덜거리다	자동사
도망치다	자동사
내치다	자타동사
짓밟다	타동사
들이쉬다	타동사
돋아나다	자동사
물구나무서다	자동사
덮치다	자동사
깔아뭉개다	타동사
몰려오다	자동사
들썩이다	자동사
돋우다	타동사
토하다	타동사
굴러가다	자동사
애끓다	자동사
신들리다	자동사
불어넣다	타동사
펴지다	자동사
굳다	자동사
날아가다	자동사
흩어지다	자동사
등지다	자동사
쓰러지다	자동사
알아차리다	타동사
울먹이다	자동사
북적대다	자동사
넓어지다	자동사
논하다	타동사
가물다	자동사
물려주다	타동사
돋치다	자동사
쫓아가다	타동사
좇다	타동사
되짚다	타동사
얼어붙다	자동사
벌어들이다	자동사
맞대다	타동사
깔보다	타동사
휘청대다	자동사
밀치다	타동사
얼룩지다	자동사
들이대다	자동사
가만있다	자동사
몰려가다	자동사
칠하다	타동사
멎다	자동사
짊어지다	타동사
조르다	자타동사
나무라다	타동사
흘겨보다	타동사
부리다	타동사
고하다	타동사
가려지다	자동사
뒤쫓다	타동사
모시다	타동사
계시다	자동사
살아오다	자동사
불어나다	자동사
박하다	타동사
끌려가다	자동사
빈둥거리다	자동사
감다	타동사
늘어놓다	타동사
간추리다	타동사
늘어서다	자동사
불러내다	타동사
춤추다	자동사
생겨나다	자동사
뜯어내다	타동사
박차다	타동사
쉬쉬하다	타동사
좇아가다	타동사
재다	자타동사
깨어나다	자동사
헤어지다	자동사
갈라서다	자동사
대주다	자타동사
잡아내다	타동사
갈아치우다	타동사
벌리다	타동사
메다	자타동사
까지다	자동사
젖다	자동사
생각나다	자동사
감치다	자타동사
들이닥치다	자동사
떠다니다	자동사
구겨지다	자동사
닳다	자동사
내쉬다	타동사
칭하다	타동사
동떨어지다	자동사
가리어지다	자동사
울부짖다	자동사
둘러서다	자동사
갈리다	자동사
이지러지다	자동사
북돋우다	타동사
싸매다	타동사
받치다	타동사
빨개지다	자동사
풀어지다	자동사
다잡다	타동사
굴러다니다	자동사
빼돌리다	타동사
업다	타동사
불어오다	자동사
베끼다	타동사
기울다	자동사
널뛰다	자동사
허물어지다	자동사
굶다	자동사
해지다	자타동사
꽂다	타동사
누다	타동사
망가뜨리다	타동사
몰려다니다	자동사
판치다	자동사
서리다	자타동사
풍기다	자동사
돌려보내다	타동사
따라다니다	타동사
발기다	자타동사
곱씹다	타동사
명하다	타동사
푸다	타동사
끌어안다	타동사
가물거리다	자동사
알아주다	타동사
돌이키다	타동사
속다	자타동사
빼앗다	타동사
흘러나오다	자동사
뛰쳐나오다	자동사
달구다	타동사
뛰어가다	자동사
돌려놓다	타동사
점하다	타동사
오르내리다	자동사
미끄러지다	자동사
넘어오다	자동사
만지작거리다	타동사
해치다	타동사
어려워하다	타동사
뿜다	타동사
등치다	타동사
틈타다	타동사
꾀다	자타동사
걷어붙이다	타동사
맞바꾸다	타동사
에워싸다	타동사
사르다	타동사
몰아가다	타동사
엎치다	자동사
날아다니다	자동사
나누어지다	자동사
몰아주다	타동사
추어올리다	타동사
치우치다	자동사
얽어매다	타동사
어긋나다	자동사
벗겨지다	자동사
점치다	타동사
뛰어내리다	자동사
내리치다	타동사
비기다	자타동사
풀어놓다	타동사
비키다	자동사
몰아세우다	타동사
기웃거리다	자동사
굶주리다	자동사
낚다	타동사
잡아들이다	타동사
몰아붙이다	타동사
처넣다	타동사
나가떨어지다	자동사
되뇌다	타동사
집어삼키다	타동사
알아맞히다	타동사
솟다	자동사
뵙다	타동사
거머쥐다	타동사
내딛다	타동사
주춤대다	자동사
돌려보다	타동사
지새우다	타동사
맞아떨어지다	자동사
행하다	타동사
파내다	타동사
골라내다	타동사
웅성거리다	자동사
애타다	자동사
까먹다	타동사
헐떡거리다	자동사
벗기어지다	자동사
밑지다	자동사
뜯어보다	타동사
되받다	타동사
날뛰다	자동사
밀어닥치다	자동사
범하다	타동사
짜이다	자동사
빗대다	타동사
깨치다	타동사
쪼들리다	자동사
끌어내리다	타동사
누그러지다	자동사
이룩하다	타동사
자아내다	타동사
움찔거리다	자동사
재미나다	자동사
할퀴다	타동사
나대다	자타동사
비켜나다	자동사
따먹다	타동사
꿰뚫다	타동사
휘다	자동사
부둥켜안다	타동사
적시다	자타동사
뿌리치다	타동사
건너뛰다	타동사
머금다	타동사
펄떡이다	자동사
쳐내다	타동사
치밀다	자동사
떨구다	타동사
삼가다	타동사
앗다	타동사
엎드리다	자동사
깔깔거리다	자동사
가시다	자동사
휘청거리다	자동사
나자빠지다	자동사
헤어나다	타동사
맞히다	타동사
긁다	타동사
소스라치다	자동사
격하다	자타동사
셈하다	타동사
떠먹다	타동사
뚫어지다	자동사
낫다	자타동사
둘러치다	타동사
틀어박히다	자동사
안치다	자타동사
졸리다	자동사
드르렁거리다	자동사
뵈다	타동사
자빠지다	자동사
피어나다	자동사
여쭈다	타동사
걸터앉다	자동사
키다	타동사
개다	자타동사
들어차다	자동사
부러워하다	타동사
결리다	자동사
맞닥뜨리다	자동사
금하다	타동사
떠돌아다니다	자동사
썰다	자동사
파래지다	자동사
우려내다	타동사
데우다	타동사
얼리다	자동사
설레다	자동사
기울어지다	자동사
디디다	타동사
들이받다	타동사
깨어지다	자동사
손대다	자동사
빈정거리다	자동사
끼이다	타동사
치이다	자동사
처박다	타동사
올라타다	자동사
다시다	타동사
박이다	자동사
오리다	타동사
물결치다	자동사
아로새기다	타동사
차가다	자동사
삐다	자동사
지피다	자타동사
뜯다	타동사
훑다	타동사
해하다	자타동사
까다	자타동사
흥얼거리다	자동사
헹구다	타동사
넘겨받다	타동사
타고나다	타동사
훔쳐보다	타동사
둘러앉다	자동사
살찌다	자동사
발하다	자동사
우거지다	자동사
늘어지다	자동사
화끈거리다	자동사
감하다	자타동사
철하다	타동사
염하다	타동사
흐트러뜨리다	타동사
맞닿다	자동사
거리끼다	자동사
거치적거리다	자동사
비집다	타동사
맘먹다	자동사
수군거리다	자동사
불나다	자동사
미적거리다	타동사
걷잡다	타동사
일삼다	타동사
뺨치다	자동사
튀기다	타동사
미끄러뜨리다	타동사
썩다	자동사
밀려오다	자동사
그늘지다	자동사
킁킁대다	자동사
칭얼대다	자동사
어루만지다	타동사
사무치다	자동사
미이다	자동사
동나다	자동사
달려나가다	자동사
잦다	자동사
논다	타동사
끼우다	타동사
괴로워하다	자동사
솎다	타동사
접붙이다	자타동사
미워하다	타동사
찌그리다	타동사
찡그리다	타동사
해치우다	타동사
젖히다	타동사
물러가다	자동사
터트리다	타동사
고이다	자타동사
치받다	자동사
솟구치다	자동사
비웃다	타동사
써넣다	타동사
마주하다	타동사
빨아들이다	타동사
사그라지다	자동사
쳐다보다	타동사
겨누다	타동사
어슬렁거리다	자동사
끙끙거리다	자동사
과하다	타동사
그리하다	자동사
우러나오다	자동사
내뱉다	타동사
헛갈리다	자동사
투덜대다	자동사
신기다	자동사
휘날리다	자동사
흩날리다	자동사
수놓다	자동사
잊어버리다	타동사
치어다보다	타동사
떠벌리다	타동사
얹히다	자동사
도리다	타동사
시시덕거리다	자동사
으르렁대다	자동사
망설이다	자동사
베내다	타동사
흩트리다	타동사
치키다	타동사
잡아가다	타동사
들끓다	자동사
욕하다	자동사
오므리다	타동사
맞먹다	자동사
쳐들어가다	타동사
뭉뚱그리다	타동사
엇나가다	자동사
비뚤어지다	자동사
내달리다	자동사
내보다	자타동사
알아채다	타동사
꿈틀대다	자동사
손꼽다	자동사
쫓아내다	타동사
일그러지다	자동사
포개지다	자동사
바래다	자타동사
놀리다	타동사
깨우치다	타동사
뺏다	타동사
홀리다	자동사
제기다	자타동사
흐느적거리다	자동사
얼빠지다	자동사
끄집어내다	타동사
부르짖다	자동사
굽이치다	자동사
탐하다	타동사
부대끼다	자동사
부러뜨리다	타동사
넘실대다	자동사
들여놓다	타동사
써내다	타동사
휘어잡다	타동사
허하다	타동사
혼나다	자동사
흐리다	타동사
줄짓다	자동사
파묻다	타동사
김새다	자동사
떠맡다	타동사
짖다	자동사
얼쩡거리다	자동사
심기다	자동사
찰랑거리다	자동사
올라앉다	자동사
맞잡다	타동사
나앉다	자동사
기하다	타동사
웅얼거리다	자동사
잡아떼다	타동사
올려다보다	자동사
반가워하다	자동사
쫓아오다	타동사
빗맞다	자동사
틀어쥐다	타동사
옥죄다	타동사
휘감다	타동사
절이다	타동사
쇠다	자타동사
우시다	자동사
늘이다	타동사
쬐다	타동사
퍼내다	타동사
뉘다	타동사
비틀어지다	자동사
옮다	자동사
더럽히다	타동사
뇌다	타동사
뒤섞다	타동사
젖혀지다	자동사
공들이다	자동사
퍼덕거리다	자동사
메기다	타동사
부시다	타동사
벌하다	타동사
뛰쳐나가다	자동사
헷갈리다	자동사
찌푸리다	자동사
가로채다	타동사
갈기다	타동사
우쭐하다	자동사
접질리다	자동사
꾸짖다	타동사
싸잡다	타동사
부끄러워하다	자동사
뜯어먹다	타동사
주리다	자동사
집적거리다	타동사
어그러지다	자동사
북돋다	타동사
들어맞다	자동사
도맡다	타동사
성나다	자동사
떠나가다	자동사
몰려나오다	자동사
욱신거리다	자동사
되돌아보다	자동사
뒤서다	자동사
속삭이다	자동사
옭아매다	타동사
쐬다	타동사
출렁거리다	자동사
모나다	자동사
애먹다	자동사
목매다	자동사
파먹다	타동사
흐려지다	자동사
킁킁거리다	자동사
핥다	타동사
돋다	자타동사
힐끔거리다	타동사
찧다	타동사
꼼지락거리다	자동사
까딱거리다	자타동사
중얼거리다	자동사
두리번거리다	자동사
겁먹다	자동사
들락대다	자동사
화내다	자동사
북적거리다	자동사
목놓다	자동사
휘어지다	자동사
움츠리다	타동사
빠트리다	타동사
쑤시다	자타동사
쪼이다	자동사
날아오르다	자동사
스멀거리다	자동사
삐걱대다	자동사
주무시다	자동사
뒈지다	자동사
덧씌우다	타동사
아파하다	자동사
비끼다	자동사
깜빡거리다	자동사
뜯어고치다	타동사
되돌아오다	자동사
들추어내다	타동사
여미다	타동사
떠내려가다	자동사
비켜서다	자동사
빚내다	자동사
헛디디다	타동사
뭉개다	타동사
번들거리다	자동사
좇아오다	타동사
맞부딪치다	자동사
치대다	타동사
더듬거리다	자동사
말라붙다	자동사
읊조리다	타동사
꼬다	타동사
안절부절못하다	자동사
팔아먹다	타동사
지지르다	자타동사
갉다	타동사
내려치다	자타동사
숨죽이다	자동사
북받치다	자동사
틀어지다	자동사
살랑대다	자동사
허우적대다	자동사
붉히다	타동사
반짝거리다	자동사
허기지다	자동사
헐뜯다	타동사
밤새다	자동사
뒤척이다	타동사
날름거리다	자동사
울먹거리다	자동사
후리다	타동사
미적대다	타동사
설익다	자동사
동여매다	타동사
솟아나다	자동사
들쑤시다	자동사
우기다	자동사
배기다	자동사
뉘우치다	타동사
불사르다	자타동사
아우러지다	자동사
시큰거리다	자동사
내오다	타동사
가만두다	타동사
넉넉잡다	자동사
물어내다	타동사
뒤바꾸다	타동사
빈정대다	자동사
틔다	자동사
비아냥대다	자동사
종잡다	타동사
값나가다	자동사
수군대다	자동사
동하다	자동사
내키다	자동사
줄잡다	타동사
쪼그리다	타동사
겁내다	타동사
게우다	타동사
노느다	타동사
우글거리다	자동사
넘어뜨리다	타동사
꿈틀거리다	자동사
곯다	자타동사
그르치다	타동사
후들거리다	자동사
퉁기다	타동사
짓이기다	타동사
웅크리다	타동사
이죽거리다	자동사
말미암다	자동사
긁어내다	타동사
윙윙거리다	자동사
보채다	자동사
까발리다	타동사
흩뜨리다	타동사
동그래지다	자동사
빚지다	자동사
스미다	자동사
매만지다	타동사
놀아나다	자동사
벌주다	타동사
팔락이다	자동사
낄낄거리다	자동사
얕보다	타동사
꺾어지다	자동사
샘솟다	자동사
떵떵거리다	자동사
너덜거리다	자동사
곯아떨어지다	자동사
둘러대다	타동사
곤두서다	자동사
막가다	자동사
우물거리다	자동사
장난치다	자동사
여의다	타동사
삐뚤어지다	자동사
절뚝거리다	자동사
화하다	자타동사
아까워하다	타동사
더러워지다	자동사
핥아먹다	타동사
따끔거리다	자동사
갸웃거리다	타동사
간질이다	타동사
팔딱이다	자동사
부릅뜨다	타동사
술렁거리다	자동사
그리워지다	자동사
깔깔대다	자동사
수보다	자타동사
번쩍이다	자타동사
뒤적이다	타동사
동이다	타동사
서성거리다	자동사
겁나다	자동사
쥐어박다	타동사
덤비다	자동사
갸우뚱거리다	자동사
재보다	타동사
내팽개치다	타동사
떠보다	타동사
덧나다	자동사
얼버무리다	자동사
내가다	타동사
뒤따라가다	타동사
쓰러뜨리다	타동사
받아넘기다	타동사
휘몰아치다	자동사
거들먹거리다	자동사
들어내다	타동사
지나다니다	타동사
잡아먹다	타동사
쏘이다	타동사
수그리다	타동사
가누다	타동사
껴입다	타동사
드티다	자동사
나붙다	자동사
폐다	자동사
들썩거리다	자동사
팽개치다	타동사
벗어젖히다	자동사
관두다	타동사
곪다	자동사
사리다	자타동사
가위눌리다	자동사
포개다	타동사
들이치다	자타동사
오글거리다	자동사
벋다	자동사
문지르다	타동사
허둥대다	자동사
내려서다	자동사
깁다	자타동사
노하다	자동사
양하다	타동사
지어내다	타동사
짚이다	자동사
뒤돌아보다	자동사
쓰러트리다	타동사
덧붙다	자동사
쪼그라뜨리다	타동사
비틀거리다	자동사
훌쩍이다	자동사
움켜잡다	타동사
절하다	자타동사
힘들이다	타동사
메치다	타동사
복받치다	자동사
몰아오다	자동사
느물거리다	자동사
뒤따라오다	타동사
데치다	타동사
노닥거리다	자동사
쓸리다	자동사
습하다	타동사
노닐다	자동사
번득이다	자동사
개키다	타동사
끄집다	타동사
조지다	타동사
흠잡다	타동사
그러모으다	자동사
몰라주다	타동사
쳐들어오다	타동사
밥하다	자동사
흉보다	타동사
좀먹다	자동사
둘러메다	타동사
찌그러지다	자동사
받히다	타동사
겁주다	자동사
야위다	자동사
문드러지다	자동사
처지르다	자동사
거슬리다	자동사
